NO assets/64x64/wall-01.xpm

SO assets/64x64/wall-01.xpm


C 0,255,255


WE assets/64x64/wall-01.xpm


F 255,255,0


EA          assets/64x64/wall-01.xpm


11111111111111
10010101000001
10000000000001
10000N00010001
10000000000001
10010000000001
11111111111111

